Wetaos Shinios	Asia
Jiamios Chaoos	Asia
Risuos Ighteos	Asia
Saudios Nuiltoos	Asia
Etoitia Buckaios	Asia
Essutia Skelatia	Asia
Lyeutia Debios	Asia
Deleos Dabios	Asia
Deneaos Lluiwios	Asia
Denoos Taseos	Asia
Mymaios Whulios	Asia
Oughitia Duwyios	Asia
Tonieos Clekios	Asia
Turaos Nysoos	Asia
Turatia Snawios	Asia
Blalios Sinios	Asia
Buriatia Moreios	Asia
Decios Ingeeos	Asia
Nakoos Seiwios	Asia
Natoios Olduos	Asia
Nubios Blenuios	Asia
Nyeos Thrauhios	Asia
Phedios Rekios	Asia
Voretia Nadios	Asia
Besoios Leneios	Asia
Byduios Nysitia	Asia
Oughautia Ustitia	Asia
Dreezios Lloehios	Asia
Eneaos Seildyos	Asia
Erutia Sametia	Asia
Essetia Aroios	Asia
Essios Peihios	Asia
Nehios Rayios	Asia
Rhireos Ardietia	Asia
Bejios Minuios	Asia
Damios Sayuos	Asia
Deleos Essotia	Asia
Denoos Kymios	Asia
Estytia Quaoos	Asia
Eteos Thayzios	Asia
Hyllios Riavios	Asia
Imuos Thrykios	Asia
Netios Osuos	Asia
Nyios Kaelios	Asia
Oldetia Enotia	Asia
Suloos Endeos	Asia
Dylaios Ghaitia	Asia
Sayatia Anitia	Asia
Estetia Urneos	Asia
Blalaos Wykios	Asia
Brayios Detoios	Asia
Clusios Swaesios	Asia
Danoos Lubios	Asia
Daunteos Kelitia	Asia
Elmetia Delatia	Asia
Elmoeos Rynuios	Asia
Engios Thryjeos	Asia
Eretia Huimyos	Asia
Etetia Snylyos	Asia
Etyos Suloos	Asia
Geujoos Ingotia	Asia
Haenyos Lyeouos	Asia
Honaos Peistios	Asia
Ighteos Raketia	Asia
Ighteos Rakoos	Asia
Ildios Oritia	Asia
Imutia Schaistoios	Asia
Leutios Ingotia	Asia
Oldaos Ageietia	Asia
Oseos Llaivios	Asia
Toucios Ackyos	Asia
Belytia Risoos	Asia
Bryxios Lyeytia	Asia
Chrisios Zyzeios	Asia
Cifios Trajios	Asia
Cimios Quaoutia	Asia
Cleguos Morios	Asia
Fourios Perios	Asia
Cylios Quatia	Asia
Dynetia Nelyos	Asia
Dyneutia Blarios	Asia
Eldaitia Taneos	Asia
Elmauos Tanuos	Asia
Elmeatia Umetia	Asia
Elmotia Ashatia	Asia
Enaytia Schuinnaios	Asia
Enthios Snuzios	Asia
Eraos Nodios	Asia
Whietios Veefuios	Asia
Asytia Bealuios	Asia
Bloodios Ineeos	Asia
Chretios Racios	Asia
Cikeios Chrebios	Asia
Clohios Skeloos	Asia
Coudios Skelios	Asia
Curaos Ackoos	Asia
Danaos Nabios	Asia
Dauyios Buraitia	Asia
Faudios Minteos	Asia
Faukoos Phiebios	Asia
Ganios Radaos	Asia
Garoeos Neboos	Asia
Kockuos Logeos	Asia
Mandoos Waraios	Asia
Nutuos Teenoios	Asia
Phymyios Dakios	Asia
Tasaeos Kadyos	Asia
Tofeos Cybeos	Asia
Ireatia Naijios	Europe
Adaos Zedeos	Europe
Athuos Perteios	Europe
Hasios Ildoos	Europe
Morios Seroos	Europe
Moseytia Oughauos	Europe
Urnutia Adios	Europe
Ustoios Tiaytia	Europe
Wikios Itios	Europe
Wokios Dyneos	Europe
Zhasaios Turitia	Europe
Isaios Elmytia	Europe
Meynoos Nitios	United Kingdom
Mosyos Aldios	Europe
Sytios Ranatia	Europe
Thruzeos Echaos	Europe
Viacios Skeletia	Europe
Whesios Gasios	Europe
Zafios Straldaos	Europe
Tiaios Suleios	Europe
Lleagaios Rawios	Europe
Doedios Strureos	Europe
Dynaos Keluos	Europe
Essotia Claynios	Europe
Ghaos Worios	Europe
Gytyos Echiatia	Europe
Hereios Ackoutia	Europe
Ightaitia Dratia	Europe
Lihios Iteetia	Europe
Nysitia Engotia	Europe
Ghaeatia Beusios	Europe
Lertaos Aleutia	Europe
Phienios Skeloios	Europe
Traeyaos Swudeos	Europe
Achios Angootia	Europe
Dretios Choqoios	Europe
Imitia Gekyios	Europe
Lafuios Estoos	Europe
Duiryos Reghoios	Europe
Nysitia Arditia	Europe
Lyeeos Ruyuios	Europe
Doirruios Enditia	United Kingdom
Ghaitia Theroos	Europe
Adotia Erieos	Europe
Aldios Riltaos	Europe
Rayatia Drelyos	Europe
Drylios Riletia	Europe
Essytia Yeroitia	Europe
Tacios Streedaios	Europe
Untitia Ildoos	Europe
Draileios Enuos	Europe
Naleyos Aldaos	Europe
Phuneos Veseios	Europe
Buhios Closios	Europe
Lyeuos Voirios	Europe
Aseetia Sneypios	Europe
Ashieos Turatia	Europe
Athios Schapios	Europe
Tiaeos Enotia	Europe
Turatia Atotia	Europe
Vorteos Sheckios	Europe
Adeetia Slanaos	Europe
Asytia Cranios	Europe
Athouos Denutia	Europe
Awutia Kinietia	Europe
Dealios Zujios	Europe
Estios Elduos	Europe
Eteios Whessyios	Europe
Hatytia Aldootia	Europe
Hazios Maiboos	Europe
Ingootia Onauos	Europe
Itiaos Engoos	United Kingdom
Lerios Keckaos	Europe
Torios Toghoios	Europe
Taieios Tasutia	Europe
Lesios Eldotia	North America
Pasyios Londios	North America
Ackaos Rucios	North America
Chaereos Ceikaos	North America
Onuos Denyos	North America
Theyjios Toinios	North America
Atitia Llonios	North America
Belayos Phenoios	North America
Lerios Eritia	North America
Lyeetia Ackotia	North America
Meymios Thrurdios	North America
Slylios Creewios	Europe
Sunios Crieltoios	North America
Zesoos Ranaios	North America
Keloos Rhutoos	North America
Zybyos Fajios	North America
Chaylaios Zolios	North America
Heyrdyos Leraos	North America
Isoos Chosios	North America
Thenios Lihios	North America
Tyeos Mosatia	North America
Whentyios Dilaos	North America
Irutia Cleimios	North America
Oldiatia Ackeos	North America
Teunios Jopyos	North America
Thomios Taseios	North America
Stoiwios Byckios	North America
Thrapios Criabios	North America
Ashaeos Redeos	North America
Aweyos Peyuios	North America
Itieos Zosios	North America
Jocoos Iauos	North America
Kinoos Myveos	Europe
Loirios Smiadios	North America
Loratia Etotia	North America
Aughutia Harios	North America
Beleios Batuios	North America
Hineos Bipios	North America
Jeaguios Emieos	North America
Kyheios Tasoios	North America
Leritia Ceroitia	North America
Lyeyos Oneos	North America
Lynoos Aseos	North America
Nissuos Teikios	North America
Nitios Cheutia	North America
Seratia Huweos	North America
Taseos Lepeios	North America
Yoelios Fuhios	North America
Bureos Echitia	North America
Llaylios Endeyos	North America
Moretia Rypios	North America
Undoos Elmaeos	North America
Unteos Trabios	North America
Unteuos Baisuios	North America
Untotia Voubios	North America
Cheoos Chatia	North America
Queetia Seritia	North America
Quorios Meameos	North America
Raryos Engatia	North America
Revoios Wastaos	North America
Satios Bladios	North America
Scheumios Ceruitia	North America
Schoboos Iaetia	North America
Skeloos Lemios	North America
Quauitia Crorroios	North America
Queetia Schanios	North America
Quoifaos Isoos	North America
Rakoos Duirios	North America
Rasios Saloios	North America
Rayetia Hateuos	North America
Rhuisaos Leretia	North America
Rileuos Dynietia	North America
Slaryios Darotia	North America
Tinetia Radauos	North America
Turiatia Traetoos	North America
Queusuios Awoos	North America
Rhiahios Ceisios	North America
Roessaios Ackoos	North America
Rubios Choifios	North America
Rujeos Tonios	North America
Schadios Smoweios	North America
Slianios Daretia	North America
Tineos Aleoetia	North America
Raleios Yeltaios	North America
Rilios Ageaitia	North America
Shyzios Rolduos	North America
Sidyios Denutia	North America
Taumios Rynyos	North America
Loritia Asheos	North America
Radetia Umutia	North America
Rothuos Zourios	North America
Sakios Loroos	North America
Sayotia Rakyos	North America
Steldios Danetia	North America
Surios Awetia	North America
Thianuos Lledios	North America
Tiauos Kalotia	North America
Tonayos Hunios	North America
Sossyos Nynios	North America
Strisios Delios	North America
Rexios Emuitia	North America
Riloos Merraos	North America
Swennaos Banutia	North America
Teinoos Gienuios	North America
Raisios Dytios	North America
Sayoeos Tasatia	North America
Rakeuos Anaios	North America
Ranitia Zaijios	North America
Reatuios Sledios	North America
Rhekeios Atoios	North America
Risiatia Jalios	North America
Shyatia Lekios	North America
Sotios Quaghaios	North America
Stredeios Atheuos	North America
Tasaos Roulios	United Kingdom
Tidios Toneios	United Kingdom
Llaraios Hatautia	United Kingdom
Morieos Kalutia	United Kingdom
Undeos Chasios	United Kingdom
Ustios Kinaos	United Kingdom
Vesios Chyhyos	United Kingdom
Vouleos Snauhios	United Kingdom
Waroetia Drojios	United Kingdom
Whaitaios Chroomuos	United Kingdom
Baedios Elmotia	United Kingdom
Theruios Ightatia	United Kingdom
Umaos Therieos	United Kingdom
Vesios Urnyos	United Kingdom
Bacios Athuitia	United Kingdom
Undaos Lenoios	United Kingdom
Urnyos Turytia	United Kingdom
Veaveios Honatia	United Kingdom
Woritia Kyjios	United Kingdom
Shatuios Issaos	United Kingdom
Trasoios Hiasios	United Kingdom
Loodios Yilios	United Kingdom
Sameos Serytia	United Kingdom
Silios Morios	United Kingdom
Lynios Thremios	United Kingdom
Pyfios Snibios	United Kingdom
